34
14
96 0 0 0 0 0 0 0 0 0 0 0 89 0 0 0 0 0 0 0 0 0 89 0 0 0 0 0 0 0 0 0 0 97 
96 0 87 87 87 87 87 87 87 87 87 87 87 0 0 0 0 0 0 0 0 0 87 87 87 87 87 87 87 87 87 87 0 97 
96 0 0 0 0 0 0 0 0 0 0 0 20 0 0 0 0 0 0 0 0 0 0 0 0 0 0 0 0 0 0 0 0 97 
96 86 87 87 87 87 87 87 87 87 87 88 20 0 0 0 0 0 0 0 0 0 0 86 87 87 87 87 87 87 87 87 88 97 
96 0 0 0 0 0 0 0 0 0 0 20 20 0 0 0 0 0 0 0 0 0 0 20 0 0 0 0 0 0 0 0 0 97 
96 0 87 87 87 87 87 87 87 87 87 20 20 0 0 0 0 0 0 0 0 0 0 20 87 87 87 87 87 87 87 87 0 97 
96 0 0 0 0 0 0 0 0 0 20 20 20 0 0 0 0 0 0 0 0 0 0 20 20 0 0 0 0 0 0 0 0 97 
96 86 87 87 87 87 87 87 87 87 20 20 20 0 0 0 0 0 0 0 0 0 0 20 20 87 87 87 87 87 87 87 88 97 
96 0 0 0 0 0 0 0 0 20 20 20 20 0 0 0 0 0 0 0 0 0 0 20 20 20 0 0 0 0 0 0 0 97 
96 0 0 0 0 0 0 0 0 20 20 20 20 0 0 30 31 32 32 33 34 0 0 20 20 20 0 0 0 0 0 0 0 97 
96 123 124 124 124 124 124 124 125 112 114 20 20 0 0 0 26 27 27 28 0 0 0 20 20 112 114 123 124 124 124 124 125 97 
96 126 131 128 128 130 130 132 127 107 109 20 20 0 0 0 23 0 0 24 0 0 0 20 20 107 109 126 127 128 130 131 132 97 
96 126 131 128 129 129 130 132 127 110 111 20 20 0 0 0 21 0 0 22 0 0 0 20 20 110 111 126 127 128 130 131 132 97 
96 69 69 69 69 69 69 69 69 69 69 69 70 133 134 134 134 134 134 134 134 134 135 68 69 69 69 69 69 69 69 69 69 97 
