140
8
72 0 0 0 0 0 0 0 0 0 0 0 0 0 0 0 0 0 0 0 0 0 0 0 0 8 0 0 8 0 0 8 0 0 20 0 0 86 87 87 87 88 20 0 0 0 0 0 0 0 0 0 0 0 0 0 0 0 0 0 0 0 0 0 0 0 0 0 0 0 0 0 0 0 0 0 0 73 77 80 80 80 80 80 80 80 80 80 80 80 80 80 76 74 74 75 0 0 0 8 0 0 0 0 0 0 0 0 0 8 0 0 0 0 1 0 0 0 0 0 97 0 8 0 0 97 0 97 98 73 74 74 74 74 74 74 74 74 74 77 
72 0 0 0 0 0 0 0 0 0 0 0 0 0 0 0 0 0 0 0 0 0 0 0 0 8 0 0 8 0 0 8 0 0 20 0 0 0 8 0 8 0 20 0 0 0 0 0 68 70 0 0 0 0 0 0 0 0 0 0 0 0 0 0 0 0 0 0 0 0 0 0 0 0 0 0 0 0 73 74 74 74 77 80 80 80 80 80 80 80 80 80 72 0 8 0 0 0 0 8 0 0 0 0 0 0 0 0 0 8 0 0 0 0 1 0 0 0 82 0 99 0 8 96 0 98 0 0 99 0 0 0 20 0 0 0 0 0 20 71 
72 0 0 0 0 0 0 0 0 0 0 0 0 0 0 0 0 0 0 0 0 0 82 0 0 8 0 0 8 0 0 8 0 0 20 0 0 0 8 0 8 0 20 0 0 0 0 68 79 72 0 0 0 0 0 0 0 0 0 0 0 0 0 0 0 0 0 0 0 0 0 0 0 0 0 0 0 0 0 8 0 0 73 74 74 77 80 80 80 80 80 76 75 0 8 0 0 0 0 86 87 87 87 87 87 87 87 87 87 88 0 0 0 0 1 0 0 0 82 0 96 0 8 98 0 97 0 0 8 0 0 0 20 30 31 32 33 34 20 71 
78 69 69 70 91 92 93 94 92 93 94 94 94 94 92 93 94 94 94 94 95 68 70 0 0 82 0 0 8 0 0 82 0 0 20 0 0 82 8 0 8 82 20 0 0 0 68 79 80 72 0 0 0 0 0 0 90 0 0 0 0 0 90 0 0 0 0 0 0 0 0 0 0 0 0 0 0 0 0 8 0 0 8 0 0 73 74 74 74 74 74 75 0 0 8 0 0 0 0 0 0 0 0 0 0 0 0 0 0 0 0 0 0 0 89 0 0 0 81 0 98 0 98 99 0 97 0 98 96 0 0 0 20 25 26 27 28 29 20 71 
80 80 80 72 0 0 0 0 0 0 0 0 0 0 0 0 0 0 0 0 0 71 72 0 0 0 0 0 8 0 0 0 0 0 20 0 0 86 87 87 87 88 20 0 0 68 79 80 80 72 0 0 0 0 0 0 82 0 0 0 0 0 82 0 0 0 0 0 0 0 82 0 0 0 0 0 0 0 0 8 0 0 8 0 0 8 0 0 8 0 0 8 0 0 8 68 70 0 0 0 0 0 0 0 0 0 0 0 0 0 0 0 0 0 0 0 0 0 82 0 98 0 0 99 0 98 0 0 98 0 14 15 20 0 23 0 24 0 20 71 
80 80 80 72 0 0 0 0 0 0 0 0 0 0 0 0 0 0 0 0 0 71 72 0 0 0 0 0 82 0 0 0 0 0 20 0 0 0 0 1 0 0 20 0 0 71 80 80 80 72 0 0 0 0 0 0 20 0 0 0 0 0 20 0 0 0 0 0 0 0 81 0 0 0 0 0 0 68 69 69 70 0 8 0 0 8 0 0 8 0 0 8 0 0 8 71 78 70 0 0 0 0 0 0 0 0 0 0 0 0 0 0 0 0 0 0 0 0 82 0 8 97 0 98 0 98 98 0 97 0 12 13 20 0 21 0 22 0 20 71 
80 80 80 72 0 0 0 0 0 0 0 0 0 0 0 0 0 0 0 0 0 71 72 0 0 0 0 0 0 0 0 0 0 0 20 0 96 0 0 1 0 0 20 0 68 79 80 80 80 72 0 0 0 0 0 0 20 0 0 0 0 0 20 0 0 0 0 0 0 0 20 0 0 0 0 0 0 71 80 80 72 0 8 0 0 8 0 0 8 0 0 8 0 0 68 79 80 72 0 0 0 0 0 0 0 0 0 0 0 0 0 0 0 0 0 0 0 68 69 70 8 8 0 96 0 8 8 0 97 0 10 11 20 133 134 134 134 135 20 71 
80 80 80 72 0 0 0 0 0 0 0 0 0 0 0 0 0 0 0 0 0 71 72 0 0 0 0 0 0 0 0 0 0 0 68 69 69 69 69 69 69 69 69 69 79 80 80 80 80 72 0 0 0 0 0 0 20 0 0 0 0 0 20 0 0 0 0 0 0 0 20 0 0 0 0 0 0 71 80 80 78 69 69 69 69 69 69 69 69 69 69 69 69 69 79 80 80 72 91 92 93 94 94 94 95 68 69 70 0 0 0 0 0 0 0 68 69 79 80 78 69 69 69 69 69 69 69 69 69 69 69 69 69 69 69 69 69 69 69 79 
