107
8
72 0 0 0 0 0 0 0 0 0 0 0 0 0 0 0 0 0 0 0 0 0 0 0 0 0 0 0 0 0 0 0 0 3 2 0 0 0 0 3 0 2 0 0 73 77 80 80 80 80 80 80 80 80 80 80 80 80 80 76 74 74 74 74 74 74 74 74 74 74 74 77 80 80 72 0 0 0 0 0 0 0 0 0 0 0 0 0 0 0 0 73 77 80 80 80 76 74 74 74 74 74 74 74 74 74 77 
72 0 0 0 0 0 0 0 0 0 0 0 0 0 0 0 0 0 0 0 0 0 0 0 0 0 112 113 114 0 0 0 0 3 2 0 0 0 0 3 0 2 0 0 0 73 74 74 74 77 80 80 80 80 80 80 80 80 80 72 0 0 0 0 0 0 0 0 0 0 0 73 74 77 72 0 0 0 0 0 0 0 0 0 0 0 0 0 0 0 0 0 73 77 80 80 72 0 0 20 0 0 0 0 0 20 71 
72 0 0 0 0 0 0 0 0 0 0 0 0 0 0 0 0 0 0 0 0 0 0 0 0 0 107 108 109 0 0 0 0 3 2 0 0 0 0 3 0 2 0 0 0 0 0 0 0 73 74 74 77 80 80 80 80 80 76 75 0 0 0 0 0 0 0 0 0 0 0 0 0 73 75 0 0 0 0 0 0 0 0 0 0 0 0 0 0 0 0 0 0 73 77 80 72 0 0 20 30 31 32 33 34 20 71 
72 0 0 0 0 0 0 0 0 0 0 0 0 0 0 0 0 0 0 0 0 0 0 0 0 112 113 115 116 114 0 0 0 3 2 0 0 0 0 86 87 88 0 0 0 0 7 0 0 0 0 0 73 74 74 74 74 74 75 0 0 0 0 0 0 0 0 0 0 0 0 0 0 0 0 0 0 0 0 0 0 0 0 0 0 81 0 0 0 0 0 0 0 0 73 77 72 0 0 20 25 26 27 28 29 20 71 
72 0 0 0 0 0 123 124 125 0 0 0 0 6 67 68 70 0 0 0 0 0 0 0 0 107 105 105 106 109 0 0 0 86 88 0 0 0 0 0 0 0 0 0 0 0 8 0 0 0 0 0 20 0 0 0 0 20 0 0 0 0 68 70 0 4 0 0 0 0 0 5 123 124 124 125 0 0 0 0 0 0 0 0 0 82 0 0 0 0 0 0 0 0 0 73 75 14 15 20 0 23 0 24 0 20 71 
72 96 0 0 0 0 120 121 122 0 0 67 68 69 69 79 72 0 0 0 0 0 0 90 0 107 105 108 106 109 0 6 0 0 0 0 0 0 0 0 0 0 0 0 68 69 69 70 0 0 0 0 20 0 0 0 0 20 0 0 0 0 71 78 70 91 94 92 93 94 94 95 126 128 130 127 0 0 0 18 19 90 0 0 0 82 0 0 0 0 0 0 0 0 0 0 0 12 13 20 0 21 0 22 0 20 71 
72 98 99 0 0 89 117 118 119 0 0 68 79 80 80 80 72 0 0 0 0 68 69 69 70 100 103 101 103 102 68 70 0 9 0 9 68 70 0 0 0 0 0 0 71 80 80 72 0 0 0 0 81 0 0 0 0 81 0 0 0 68 79 80 72 0 0 0 0 0 0 0 126 128 130 127 0 0 0 16 17 90 0 0 68 69 70 0 0 0 0 0 0 0 0 0 0 10 11 20 133 134 134 134 135 20 71 
78 69 69 69 69 69 69 69 69 69 69 79 80 80 80 80 72 0 0 0 0 71 80 80 78 69 69 69 69 69 79 78 69 69 69 69 79 72 0 0 0 0 0 0 71 80 80 78 69 69 69 69 69 69 69 69 69 69 69 69 69 79 80 80 72 0 0 0 0 0 0 0 68 69 69 69 69 69 69 69 69 69 69 69 79 80 78 69 69 69 69 69 69 69 69 69 69 69 69 69 69 69 69 69 69 69 79 
